111111111
19RRR0281
111110111
1RRD10101
1U2D10101
1ULL13101
111111111
