11111111111111111111111111111111111111111111111111
11000000000000000000000000000000000000000000000001
10000000000000000000000000000000000000000000000001
10000000000000000000000000000010101010101010100001
10090021000000000000000000000001010101010101000001
10000040000000000000000000000000000000000000000001
11141113000000000000000000000000000000000000000001
11122410000000000000000000000000000000000000000001
11431410000000000000000000000000000000000000000001
11453310000000000000000000000000000000000000000001
11011110000000000000000000000000000000000000000001
11010050000000000000000000000000000000000000000001
10000000000000000000000000000000000000000000000001
10000000000000000000000000000000000000000000000001
10000000000000000000000000000000000000000000000001
10000000000000000000000000000000000000000000000001
10000000000000000000000000000000000000000000000001
10000000000000000000000000000000000000000000000001
11111111111111111111111111111111111111111111111111
