11111111111111111111111111111111111111111111111111
10000000000000000000000000000000000000000100000001
10000000000000000000000000000000000000000100001001
10000000000000000000000000000100000000000100001001
10000000000000000000000000000100000000000000090001
10000000000000000000000000000100000000000000000001
10000000000000011111111111111100000000000000000001
10000000000000010000000000000000000000000000000101
10000000000000010000000000000000000000000000000001
10000000000000010000000000000000000000000000000001
10000000000000010000000000000000000000000000000001
10000000000000010000000000000000000000000000000001
10000000000000000000000000000000000000000000000001
10000000000000000000000000000000000000000000000001
10000000000000000000000000000000000000000000000001
10000000000000000000000000000000000000000000000001
10000000000000000000000000000000000000000000000001
10000000000000000000000000000000000000000000000001
11111111111111111111111111111111111111111111111111
