1111111111111111111111
1u00001000000000001111
1011101010101010011111
10s0l000l0l0l011111111
1110011111u10d0000l001
1010r000s001u00000l091
10101101u1010rs1111001
100001010101u001s00001
11110r000d0d1111u11111
1000r000u0u011s0011111
1011u1110s0r0r0du11111
1000011111r0r0u0011111
10111000100d0l0su11111
10s0l000l0u00l11011111
101101s1010s0001000111
1010000101111101000081
100101010d000l01000081
100101u1u0000l01000111
100101010s011111011111
100000u111r000s0011111
1000111111111111111111
1111111111111111111111
