11111111111111111111111111111111111111111111111111
11060000000000000000000000000000000000000000000001
10000000000D00000000000000000000000000000000000001
1000000000L9000D0000000000000010101010101010100001
100000R1008180000000000000000001010101010101000001
100000D0000022002200000000000000000000000000000001
111D111L000020300200000000000000000000000000000001
111RRD10000022222200000000000000000000000000000001
11DL1D10000000000000000000000000000000000000000001
11DULL10000000000000000000000000000000000000000001
11011110000000000000000000000000000000000000000001
110100U0000000000000000000000000000000000000000001
10000000000000000000000000000000000000000000000001
10000000000000000000000000000000000000000000000001
10000000000000000000000000000000000000000000000001
10000000000000000000000000000000000000000000000001
10000000000000000000000000000000000000000000000001
10000000000000000000000000000000000000000000000001
11111111111111111111111111111111111111111111111111
