11111111111
10010000011
10900000001
10000010001
11111111111
