1111111
1000001
1000001
1000001
1000001
1090001
1111111
