111111111111111111111111111
190000000000001000000000001
101110101011111011101010111
100010101000000000101010001
101011111110111010111010101
101000000010001010031010101
101110111011101111111110111
100010001000100000000010001
101011111110111011111110101
101000000010001000000010101
101010111111101010111011101
101010000000101010001000101
101010101010101010111010101
101010101010101010001010101
101011101011101111111010101
101000101000100000001010101
101010111010101110111110111
101010001010100010000010001
101010101011101010101010111
101010101000101010101010201
101010111010101010111110101
101010001010101010000010101
101011101111111110111110101
101000100010101010100310101
101010111110101011101110101
101010000000000000000010181
111111111111111111111111111
