11111111111
1918L0l0001
101r00000D1
101000u00l1
10100r00D11
101u10D1001
102sl0D1001
101r0UD1001
1310u00l071
11111111111
