111111111111
19RRRRR01111
1D10LL1D1111
1DLL1UL00001
1D1U100L1011
1D0U0L01RD11
1D0U00110D71
1D1U1810UD01
10R0111U1D01
11DL100U1R01
16L0LLL0LLL1
111111111111
