11111111111111111111111111111
10000000000000000000000000001
10000000000300090005000000001
10000000000000000000000000001
10000022200020002000222000001
10000200020020002000200000001
10000200020020002000220000001
10000200200020002000200000001
10000021014441220444122000001
10000004000000404000000000001
10000004022200401000200000001
10000004020020401000200000001
10000004020020401000200000001
10000000024414002444100000001
10000004012200000222040000001
10000004040000000000040000001
10020004042220002000240222001
10020004010002002000240200001
10020004024441002444100220001
10020000020002000202000200001
10022220002220000020000222001
10000000000000000000000000001
10000000000000080000000000001
10000000000000000000000000001
10000000000000000000000000001
11111111111111111111111111111
