11111111111111111111111111111
10000000000000000000000000001
10000000030009000000000000001
10000000000000000000000000001
10000011100020002000222000001
10000100010020002000200000001
10000100010020002000220000001
10000100100020002000200000001
10000011010002220000222000001
10000000000000000000000000001
10000000012200002000200000001
10000000010020002000200000001
10000000010020002000200000001
10000000010020002000200000001
10000000011100000222000000001
10000000000000000000000000001
10020000002220002000200111001
10020000020002002000200100001
10020000020002002000200110001
10020000020002000202000100001
10022220002220000020000122001
10000000000000000000000000001
10000000000008000000000000001
10000000000000000000000000001
11111111111111111111111111111
