11111111111
1918L0l0001
101r00000d1
10100r00D01
101u10u0Dl1
102sl0D10D1
101r0UD7001
1310u00l001
11111111111
