11111111111111111111111111
11000000000000000110000001
10000090000000000000000001
10000000000000000000110001
10000000001110000000000001
11111111111111111111111111
