111111
191081
101001
100001
100101
111111
