111111
101081
191001
100001
100101
111111
