111111
191081
100001
100001
100101
111111
